#Level 2 — The Castle Threshold

#Introduce stairs, small spike pits, and multiple platform levels.

000000000000000000000000000000000000000000
000000000000000000000000000000000000000000
000000000000000000000000000000000000000000
000000000000000000000000000000000000000000
000000000000000000000000000000000000000000
000000000000000000000000000000000000000000
0000000000000000000000000000000000000V0000
000000000000000000000000000000000000111000
00000000000000000000000000000000000S111000
0000000000000000000000000000000000S1111000
000000000000000000000000000000000S11111000
000000000000000000000000000000001111111000
000000000000000000000000000000000000000000
00000000000000000000LMX0000000000000000000
000000000000000000000000000E00000000000000
000000000000LMX000000000001111000000000000
000000000000000000000000000000000000000000
000000000000000000000000000000000000000000
0P0000E00000000000000000000000000000000000
111111110001111110000111110001111111111111
11111111TTT111111TTTT11111TTT1111111111111
111111111111111111111111111111111111111111