#Level 1 — The Courtyard Approach

#Teach basic movement, jumping, and introduce a single enemy.

000000000000000000000000000000000000000000
000000000000000000000000000000000000000000
000000000000000000000000000000000000000000
000000000000000000000000000000000000000000
000000000000000000000000000000000000000000
000000000000000000000000000000000000000000
000000000000000000000000000000000000000000
000000000000000000000000000000000000000000
000000000000000000000000000000000000000000
000000000000000000000000000000000000000000
000000000000000000000000000000000000000000
000000000000000000000000000000000000000000
000000000000000000000000000000000000000000
000000000000000000000000000000000000000000
000000000000000000000000000000000000000000
00000000000000000000000000000000000000V000
0000000000000000000000000000000000000LMX00
000000000000000000000000000000000000000000
0P000000000000000E000000000000000000000000
111111111000111111111100011111111111111111
111111111000111111111100011111111111111111
111111111111111111111111111111111111111111