#Level 6 — The Gauntlet Bridge

#Long jumps, spike pits below small platforms.

000000000000000000000000000000000000000000
000000000000000000000000000000000000000000
000000000000000000000000000000000000000000
000000000000000000000000000000000000000000
000000000000000000000000000000000000000000
000000000000000000000V00000000000000000000
000000000000000000001110000000000000000000
000000000000000000000000000000000000000000
000000000000000000000000000000000000000000
000000000000001110000000000000000000000000
000000000000000000000000000000000000000000
000000000000000000000000000111E00000000000
000000000000000000000000000000000000000000
000000000001110000000000000000000000000000
000000000000000000000000000000000000000000
000000000000000000000000000000000000000000
0P00000E00000000000E000000000000000000000E
000000000000000000000000000000000000000000
111111000TTT00111110000TTT0111110000TTT011
1111110TTTTTT01111100TTTTTT1111100TTTTT011
111111111111111111111111111111111111111111
111111111111111111111111111111111111111111