#Level 5 — The Bell Tower

#Primarily vertical traversal. Ascend through enemies.

00000000000000000000000V000000000000000000
000000000000000000000LMX000000000000000000
000000000000000000000000000000000000000000
000000000000000000000000000000000000000000
000000000000000000000000000LMX000000000000
000000000000000000000000000000000000000000
000000000000000000000000000000000000000000
000000000000LMX000000000000000000000000000
000000000000000000000000000000000000000000
000000000000000000000000000000000000000000
000000000000000000000000LMMX00000000000000
000000000000000000000000000000000000000000
000000000000000000000000000000000000000000
00000000000LMX0000000000000000000000000000
000000000000000000000000000000000000000000
000000000000000000E00000000000000000000000
00000000000000000LMMX000000000000000000000
000000000000000000000000000000000000000000
0P0000000000000000000000000000000000000000
111111000000000000000000000000000000000011
111111000000000000000000000000000000000011
111111111111111111111111111111111111111111