WWWWWWWWWWWWWWWWWWWWWWWWWWWWWWWWWWWWWWWWWW
W0000000000000000000000000000000000000000W
W0000000000000000000000000000000000000000W
W0000000000000000000000000000000000000000W
W0000000000000000000000000000000000000000W
W0000000000000000000000000000000000000000W
W0000000000000000000000000000000000000000W
W00000000000000000000000000000000000V0000W
W0000000000000000000000000000000000000011W
W0000000000000000000000000000000000000111W
W0000000000000000000000000000000000001111W
W1111111111111111111111111111111100011111W
W0000000000000000000000000000000000000000W
W0000000000000000000000000000000000000000W
W0000000000000000000000000000000000E00000W
W0001111111111111111111111111111111111111W
W0000000000000000000000000000000000000000W
W0000000000000000000000000000000000000000W
W0P000E0000E0000E000000000000000000000000W
W111TT111TT111TT1110001110001110001110001W
W111111111111111111TTT111TTT111TTT111TTT1W
W1111111111111111111111111111111111111111W