#Level 9 — The Oathbreaker's Sanctum

#The final test. Punishing layout, massive drops, complex verticality.

000000000000000000000000000000000000000000
00000000000000000000V000000000000000000000
0000000000000000000LMX00000000000000000000
000000000000000000000000000000000000000000
000000000000LMX00000000000LMX0000000000000
000000000000000000000000000000000000000000
000000000000000000000000000000000000000000
000000LMX00000000000000000000000LMX0000000
000000000000000000000000000000000000000000
0000000000000000000E00E0000000000000000000
00LMX0000000000000LMMMX00000000000000LMX00
000000000000000000000000000000000000000000
000000000000000000000000000000000000000000
0000000000LMX0000000000000000LMX0000000000
000000000000000000000000000000000000000000
000000000000000000000000000000000000000000
00000LMX0000000E0000000000E0000000LMX00000
000000000000011110000000011110000000000000
00P000000000000000000000000000000000000000
111000000000000000000000000000000000000111
111TTTTTTTTTTTTTTTTTTTTTTTTTTTTTTTTTTTT111
111111111111111111111111111111111111111111