#Level 10 — The Final Vow (Boss Arena)
#Wide arena designed for the Void Sentinel fight.

WWWWWWWWWWWWWWWWWWWWWWWWWWWWWWWWWWWWWWWWWW
W0000000000000000000000000000000000000000W
W0000000000000000000000000000000000000000W
W0000000000000000000000000000000000000000W
W0000000000000000000000000000000000000000W
W0000000000000000000000000000000000000000W
W0000000000000000000000000000000000000000W
W0000000000000000000000000000000000000000W
W0000000000000000000000000000000000000000W
W0000000000000000000000000000000000000000W
W0000000000000000000000000000000000000000W
W0000000000000000000000000000000000000000W
W0000000000000000000000000000000000000000W
W0000000000000000000000000000000000000000W
W0000000000000000000000000000000000000000W
W0000000222000000000000000000000222000000W
W0P0000000000000000000000000000000000000VW
111111111111111111111111111111111111111111
111111111111111111111111111111111111111111
111111111111111111111111111111111111111111