#Level 3 — The Broken Rampart

#Introduce damaged bricks and vertical navigation.

000000000000000000000000000000000000000000
000000000000000000000000000000000000000000
000000000000000000000000000000000000000000
000000000000000000000000000000000000000000
00000000000000000000000000000000000V000000
00000000000000000000000000000000000DD00000
00000000000000000000000000000000000DD00000
000000000000000000000000000000000LMX000000
000000000000000000000000000000000000000000
0000000000000000000000000000LMX00000000000
000000000000000000000000000000000000000000
0000000000000000000000LMX00000000000000000
000000000000000000000000000000000000000000
0000000000000000LMX00000000000000000000000
000000000000000000000000000000000000000000
0000000000LMX00000000000000000000000000000
0000000000000000000000000000000000000E0000
000000000000000000000000000E00000000111111
0P0000E00000000000000000011111111111111111
111111110001111111100000011111111111111111
111111110001111111100000011111111111111111
111111110001111111100000011111111111111111