#Level 4 — The Spike Hall

#Trap gauntlets forcing calculated leaps.

000000000000000000000000000000000000000000
000000000000000000000000000000000000000000
000000000000000000000000000000000000000000
000000000000000000000000000000000000000000
000000000000000000000000000000000000000000
000000000000000000000000000000000000000000
000000000000000000000000000000000000000000
000000000000000000000000000000000000000000
WWWWWWWWW0000WWWWWWWW00000WWWWWWW00000WWWW
WWWWWWWWW0000WWWWWWWW00000WWWWWWW00000WWWW
WWWWWWWWW0000WWWWWWWW00000WWWWWWW00000WWWW
000000000000000000000000000000000000000000
000000000000000000000000000000000000000000
000000000000000000000000000000000000000000
000000000000000000000000000000000000000000
000000000000000000000000000000000000000000
0P000000000E00000000000E0000000000E0000V00
000000000000000000000000000000000000000000
111111111TTTT11111111TTTTT1111111TTTTT1111
111111111TTTT11111111TTTTT1111111TTTTT1111
111111111111111111111111111111111111111111
111111111111111111111111111111111111111111